A
abrupt - Внезапный - Sudden and unexpected. Curt or brusque in manner.
adaptive - Приспосабливающийся - Able to change and evolve as needed.
add up - Суммировать - To calculate the total.
adopted - Усыновлённый - About child from someone else’s family who legally became the child of new parents.
adoptive - Родитель/ли усыновители - About family that legally became parents of someone else’s child.
ancestral - Фамильный - Coming from family lineage, ancestors.
appetite - Аппетит - The feeling hunger.
at its heart - По своей сути - Most important part of something.
avoid distraction - Избегать отвлечения - To try to keep the focus.
a tall order - Трудная задача - A very difficult task.
a touch of - Немного - A small size.
B
be in the red - Быть в долгах - To owe money. To be in debt.
biofuel - Биотопливо - Fuel produced from plant material.
blood pressure - Кровяное давление - Effect of blood on the walls of the arteries.
bold - Смелый - Readiness to take risks.
build up - Накапливать - A slow increase of something.
C
capture - Захватить - To get control of a place, attention or person with force.
carbon footprint - Углеродный след - The total amount of greenhouse gases produced by human activities.
carbon-neutral - Углеродно-нейтральный - Not generating carbon emissions.
cardiovascular disease - Сердечно-сосудистые заболевания - Medical conditions of heart and blood vessels.
cattle - Коровий скот - Cows, raised for meat or milk.
caught red-handed - Пойманным с поличным - Caught in the act of doing something wrong.
cereal - Зерновой - Plant that is grown to produce grain for food.
cholesterol levels - Уровень холестерина - Blood fat level.
chronic pain - Хроническая боль - Long-term pain.
circulation - Кровообращение - The movement of blood around your body.
concentration - Концентрация - Focusing all attention on a task or subject.
conjure up - Представить - To bring a thought, picture or idea into the mind.
consumption - Потребление - Something that someone uses, eats or drinks.
convey - Передать - Clear express something or to transport someone or something.
cut back on - Уменьшить - To reduce amount of something.
cut out - Исключить - To stop using something.
cut through red tape - Пройти сквозь бюрократию - To navigate through bureaucratic procedures efficiently.
D
desired - Желаемый - Something that is wanted.
digestion - Пищеварение - Process of breaking down food in the body.
disruption - Срыв - To interrupt something and stop it continuing.
disruptive - Прервать - To interrupt something and stop it continuing.
drastic - Резкий - Is sudden and extreme.
drift off - Заснуть - To gradually fall asleep.
drive somebody to - Заставить кого-то - To force someone to do something.
E
energize - Заряжать энергией - To supply with energy something or someone.
ethnic - Этнический - Relaying to a certain race of people.
evoke - Вызывать чувства, эмоции - To make someone remember something or feel an emotion.
F
facilitate - Облегчать - To make something easier.
festivities - Празднества - Celebrations for happy occasions.
fiber - Клtтчатка - Substance in plants that cannot be absorbed.
fit something into - Вписать что-то в - To find a way to include something in plans.
flip side - Обратная сторона - The opposite or reverse aspect of a situation.
FOMO - Страх упустить что-то важное - Fear of Missing Out something important.
foodstuffs - Продукты питания - A substance used as food.
fossil fuel - Ископаемое топливо - Fuel made of ancient organic remains.
from top to bottom - Сверху донизу - Completely, including every detail.
fundamental - Основной - Basic and essential.
fundamentally - Фундаментально - In a way that affects the most important aspects.
G
genealogy - Генеология - Science that studies families, their history, and origins.
genes - Гены - The basic physical and functional units of heredity. Parts of DNA.
genetic - Генетический - Related to genes and heredity.
get accustomed to - Привыкнуть к - Become used to something over time.
get at - Достать до - Try to reach or understand something.
get attached to - Привязаться к - Form of emotional connection with someone or something.
get blown away by - Поражён чем-то - By extremely surprised by something.
get complicated - Усложниться - Become difficult to understand.
get frustrated - Впасть в отчаянье - Feel really upset.
get lost - Потеряться - Become unable to find a physical or mental way.
get rid of  - Избавиться от - Remove of something or someone.
get something straight - Понять правильно - Understand something correctly.
get the go-ahead - Получить разрешение - Receive permission for something.
get the green light - Получить разрешение - get permission or approval.
gradual - Постепенный - Happening slowly over a period of time.
grains - Зерновые - Seeds from grass that are eaten as food.
greenhorn - Новичок - A person who is not experienced.
green around the gills - Бледный, как умерший - Looking pale or really sick.
green party - Партия зеленых - A political party that focuses on environmental and social issues.
green thumb - Опытный овощевод - Having a talent for gardening.
go off the rails - Сорваться с катушек - To become chaotic.
gut reaction - Инстинктивная реакция - Intuitive response based on feelings.
H
hereditary - Наследственный - Passed from parent to child through genes.
honor - Честь - About human or something else qualities worthy of respect.
I
immune system - Имунная система - Body’s defense system.
imply - Подразумевать - To hint at something without directly saying it.
inherit - Наследовать - Receive genes from parents or something physical when they die.
innovative - Инновационный - Using new methods or ideas.
internal organs - Внутренние органы - Organs inside the body.
interrupt - Прерывать - To stop someone while they are talking or doing something.
in and of itself - Само по себе / в общем - Intrinsically.
inherently - По своей природе - Natural and basic part of something.
It’s a doable - Это осуществимо - About something that possible.
I don’t buy it - Я не верю - Expressing disbelief about something.
J
joints - Суставы - Places in body where two bones meet.
K
keep somebody up - Не давать уснуть - To prevent someone from sleeping.
knock-on effect - Цепной эффект - Unplanned consequence of an event.
L
lasting - Долговечный - Continuing to exist for a long time.
livestock - Сельхоз животные - Animals that are kept on farms.
low-carbon - Низкоуглеродный - Generating small carbon emissions.
low-emission - Низкий выброс - Generating a small amount of bad substances.
M
minority language - Язык меньшинств - Language spoken by a minority group.
more often than not - Чаще всего - Most of the time.
muted - Приглушённый - Subdued or softened.
N
neutral - Нейтральный - Unbiased. Not strong or bright.
nutritious - Питательный - Food contains substances to stay healthy.
O
off-grid - Вне сети - Not connected to the public utilities.
P
pack something into - Уместить что-то в - To fit something into a limited space or time.
pastel - Пастельный - Soft and light colors.
per se - Само по себе - By or in itself.
physical stimulants - Физические стимуляторы - Substances or activities that increase physical energy.
posture - Осанка - The way a person holds their body.
power - Энергия / Мощность / Власть - Control over people and events. Energy.
profound - Глубокий - Having deep meaning.
Q
R
rack up - Раздобыть - To get or achieve a lot of something.
radical - Радикальный - Extreme or drastic.
reflect - Отражать, Отображать - To represent or mirror light, sound, etc.
refreshing - Освежающий - Giving a sense of renewal and less tired.
renewable - Возобновляемый - Can be complete again.
resonate with - Найти отклик - To have a importance for someone. To evoke a strong response.
rites - Обряды - Traditional ceremonies or rituals.
S
saturated - Насыщенный - Colors that are intense and harsh.
sedentary lifestyle - Сидячий образ жизни - A way of living with low physical activity.
self-sustainable - Самодостаточный - Able to be supported without external support.
see red - Сердиться - To become very angry.
shake-up - Коренная реорганизация - A drastic reorganization or change.
shortage - Недостаток - A situation in which there is not enough of something.
side effects - Побочные эффекты - Harmful treatment effects.
signify - Означать - To be a sign of something.
sleep deprivation - Недостаток сна - Lack of sleep.
slip away - Ускользнуть - To quietly leave unnoticed.
slowly but surely - Медленно, но верно - Making progress gradually.
solar panels - Солнечные панели - Devices that convert sunlight into energy.
split-second thinking - Мгновенное мышление - Making really quick solutions.
stay on track - Придерживаться плана - To stand to the original plan.
subtle - Тонкий - Delicate and understated. Not easy to notice.
supply - Поставка - To provide things that people need, often over a long time.
sweeping - Обширный - Affecting a large area or number of people.
symbolize - Символизировать - To represent something.
T
take a quick peek - Быстро взглянуть - To look fast and short at something.
tension - Напряжение - Mental or emotional strain.
transmit - Передавать / Транслировать - To convey from one person, place, or thing to another.
turn red - Покраснеть - To become confused or angry.
U
unforeseen - Непредвиденный - Not expected.
V
vibrant - Яркий - Vivid colour or striking person.
W
wholesome - Полезный - About food that good for your health.
wind down - Расслабиться - To relax after something hard.
X
Y
Z